# Canonical names for translations
# 
# Copyright (C) 2014 Free Software Foundation, Inc.
#
# This file is part of GNUnited Nations.
# GNUnited Nations is free software: you can redistribute it and/or
# modify it under the terms of the GNU General Public License as
# published by the Free Software Foundation, either version 3 of the
# License, or (at your option) any later version.
#
# GNUnited Nations is distributed in the hope that it will be useful,
# but WITHOUT ANY WARRANTY; without even the implied warranty of
# MERCHANTABILITY or FITNESS FOR A PARTICULAR PURPOSE.  See the
# GNU General Public License for more details.
#
# You should have received a copy of the GNU General Public License
# along with GNUnited Nations. If not, see <http://www.gnu.org/licenses/>.
#
# Every line of this file either begins with `#' (lines of comments)
# or contains three tab-separated fields for a language:
# suffix for files with translations in the language,
# language name in English, and language name in the language itself.
#
# The lines are sorted alphabetically by language suffix.
#
# As an exception, English is listed first because it is normally
# the original language of the article.
en	English	English
af	Afrikaans	Afrikaans
ar	Arabic	العربية
az	Azerbaijani	Azərbaycanca
bg	Bulgarian	български
bn	Bengali	বাংলা
bs	Bosnian	bosanski
ca	Catalan	català
cs	Czech	čeština
da	Danish	dansk
de	German	Deutsch
el	Greek	ελληνικά
eo	Esperanto	Esperanto
es	Spanish	español
fa	Farsi (Persian)	فارسی
fi	Finnish	suomi
fr	French	français
gl	Galician	galego
he	Hebrew	עברית
hr	Croatian	hrvatski
hu	Hungarian	magyar
id	Indonesian	Bahasa Indonesia
it	Italian	italiano
ja	Japanese	日本語
kn	Kannada	ಕನ್ನಡ
ko	Korean	한국어
lt	Lithuanian	lietuvių
mk	Macedonian	македонски
ml	Malayalam	മലയാളം
nb	Norwegian (Bokmål)	norsk (bokmål)
nl	Dutch	Nederlands
nn	Norwegian (Nynorsk)	norsk (nynorsk)
pl	Polish	polski
pt	Portuguese	português
pt-br	Brazilian Portuguese	português do Brasil
ro	Romanian	română
ru	Russian	русский
sh	Serbo-Croatian	srpsko-hrvatski
sk	Slovak	slovenčina
sl	Slovenian	slovenščina
sq	Albanian	Shqip
sr	Serbian	српски
sv	Swedish	svenska
ta	Tamil	தமிழ்
tl	Tagalog	Tagalog
tr	Turkish	Türkçe
uk	Ukrainian	українська
uz	Uzbek	Oʻzbekcha
zh-cn	Chinese (Simplified)	简体中文
zh-tw	Chinese (Traditional)	繁體中文
